BROWSER	B R AW Z ER
CATHY	K AE TH IY
CLOSE	K L OW S
CLOSE(2)	K L OW Z
DEPLOY	D IH P L OY
DISCOVERY	D IH S K AH V ER IY
DISCOVERY(2)	D IH S K AH V R IY
FILE	F AY L
GO	G OW
HI	HH AY
INITIATE	IH N IH SH IY EY T
JUSTPERFORM	JH AH S T P ER F AO R M
MANAGER	M AE N AH JH ER
MANAGER(2)	M AE N IH JH ER
MODELLING	M AA D AH L IH NG
OPEN	OW P AH N
PROCESS	P R AA S EH S
PROCESS(2)	P R AO S EH S
TO	T UW
TO(2)	T IH
TO(3)	T AH
